#######
#.@ # #
#$* $ #
#   $ #
# ..  #
#  *  #
#######

#######
#.@ # #
#$* $ #
#   $ #
# ..  #
#  *  #
#######

###########
#  .##    #
#   .#    #
## .##$$$ #
#.  .#    #
## #   $$ #
#    @    #
#         #
###########
